NO ./texture/north.xpm
SO ./texture/south.xpm
EA ./texture/west.xpm
WE ./texture/east.xpm

F 235,164,135
C 135,206,235

1111111111
1000011111
1000101001
1010010101
1000010001
1001000101
1000000W01
1000010001
1000000101
1111111111