NO ./texture/north.xpm
SO ./texture/south.xpm
EA ./texture/west.xpm
WE ./texture/east.xpm
F 200,100,150
C 300,300,650

1111111111
1000000001
1000000001
1000100001
1000010001
1000000001
1000000001
1000N10001
1001100001
1111111111
