WE ./texture/east.xpm
NO ./texture/north.xpm
SO ./texture/south.xpm
EA ./texture/west.xpm

F 2,0,0
C 100,100,40




 1111111111111           
111110111111                               
100101101111 
10101101   
1000111111
 1001001011   
1001000111  
100E010001  
1000000011  
 110111111111 
111111111
1111001111 
1101111111111 
 1101 
 111111                         


