NO ./texture/north.xpm
SO ./texture/south.xpm
EA ./texture/west.xpm
WE ./texture/east.xpm
F 200,100,150
C 300,300,650

1111111111
1111111111
1100100011
1100010011
1100000011
1100000011
1100000011
1100N10011
1111111111
1111111111