WE ./texture/east.xpm
NO ./texture/north.xpm
SO ./texture/south.xpm
EA ./texture/west.xpm

F 2,0,0
C 255,0,0




 1111111111111   
111110111111111
100101101111
10101101
10001101
 1001000101
1001000111
100E010001
1000000011
 110111111          11111
1111                   11111
111                    1001111
11011 1                1111111
 1101        111    
 111111


