WE          ./texture/east.xpm
NO          ./texture/north.xpm
SO          ./texture/south.xpm
EA ./texture/west.xpm

C                   12,156,125
F                   80,0,50





11111111111111
111110111111111
1000101101111
100101010111111
11001110W100011
 11100100010111
11110001000111
10000100011 111
1000000011
11011111 11111
11111111
111101111
11011 1    1111111
1101111
111111