NO ./texture/north.xpm
SO ./texture/south.xpm
EA ./texture/west.xpm
WE ./texture/east.xpm
F 200,100,150
C 300,300,650

1111111111
1000000001
1000000001
100N001001
1011111001
1000001001
1000001001
1001011001
1001100001
1111111111
